          ########################### 
        ############################## 
      ######  ######################## 
      ###         ###################### 
     ######               ################# 
     #########  ####              ############ 
     ################  ##         ########## 
     ####################         ########## 
    #####################        ########### 
    ######################      ############# 
    #######################    ##   ######### 
    #######################  # @######  ####### 
    ####################### ### #####  ###### 
    ############# ######## ###  ######  ###### 
    ####################### ###          ##### 
     ##########  #######  ## #          ##### 
     ##########   ####   ### ## ##       ##### 
     #######     ####  ###             ###### 
      ######       ### ###             ####### 
     ######          ####   ######    ######### 
    ####            ###    ######   ######## 
   #####            #####           ######### 
  #####            ########       ########## 
 #####            ###########     ############# 
#####            #########        ######### 
####            ###    ##         ######## 
##            ####     ##          ###### 
##           ###      ##            ###### 
###         #####      ##              ###### ### 
 ##        #####       ###              ###   #### ## 
 ###      ####        ####               ###     #### 
  ##     ####         #####                ####     ## 
  ##    ######  ##    #######                ####    ## 
   ##   #####  ##    #########     ##         ####  ## 
   ##   ####  ##    ###########     ##        ######## 
   ###  #   ##    ##############    ##        ######## 
   ###      ###  #################    #        ######### 
    ##     ##  ###################   #        ########### 
   ###     ## #####################  #        ############ 
   ####    ## ###################### #       ############## 
   ####    ######################### ##     ############### 
   #####    ###########################    ################ 
  ######     ####################### ###  ################# 
  ######     ########################  #################### 
  #######     ######################    ################## 
  ################################      ################ 
  ######### ########################################## 
  ##########                      #  ############### 
   ##########                   ###   ##       ### 
    ##########                #####    #