#######################################
##      ##  ##  ##  ##  ##      ### ###
##      ##  ##  #####   ####    ## # ##
##      ##  ##  ##  ##  ##      ##   ##
######   ####   ##  ##  #####   ##   ##
#                  @                 ##
######  #####    ####   ##  ##  ##   ##
  ##    ##  ##  ##      ##  ##  ### ###
  ##    #####    ####   ##  ##  ## # ##
  ##    ##          ##  ##  ##  ##   ##
#######################################